########################
##                    ##
##                    ##
##     ##             ##
##     ##             ##
##                    ##
##                    ##
##      ##            ##
##      ##            ##
##                    ##
##                    ##
##      ####  ####    ##
##                    ##
##                    ##
########################