########################
#                      #
#                      #
#                      #
#                      #
#                      #
#                      #
#       ##             #
#       ##             #
#                      #
#                      #
#                      #
#                      #
#                      #
########################