########################
##                    ##
##                    ##
##     ##             ##
##     ##       #     ##
##                    ##
##                    ##
##      ##        ##  ##
##      ##            ##
##                    ##
##                    ##
##      ####  ####    ##
##                    ##
##                    ##
########################